000000000000;
010110000000;
011100000000;
010110000000;
011100000000;
000000000000;
000000000000;
000000000000;
000000000000;