00000000000;
01011101110;
01110111010;
01011101110;
01110111010;
01011101110;
01110111010;
01011101110;
01110111010;
01011101110;
00000000000;