000000000000000;
010111011101110;
010101010101010;
010101010101010;
010101010101010;
010101010101010;
010101010101010;
010101010101010;
010101010101010;
010101010101010;
010101010101010;
010101010101010;
010101010101010;
011101110111010;
000000000000000;